{
"tipo": [
[0, 0, 0, 0, 0, 0, 0, 0, 0, 0, 0, 0, 0, 0, 0, 0, 0, 0, 0, 0],
[0, 0, 0, 0, 0, 0, 0, 0, 0, 0, 0, 0, 0, 0, 0, 0, 0, 0, 0, 0],
[0, 0, 0, 0, 0, 0, 0, 1, 1, 1, 1, 1, 1, 0, 0, 0, 0, 0, 0, 0],
[0, 0, 0, 0, 0, 1, 1, 2, 2, 2, 2, 2, 2, 1, 1, 0, 0, 0, 0, 0],
[0, 0, 0, 0, 1, 2, 2, 8, 8, 8, 6, 6, 6, 2, 2, 1, 0, 0, 0, 0],
[0, 0, 0, 1, 2, 8, 4, 4, 8, 8, 6, 6, 7, 7, 6, 2, 1, 0, 0, 0],
[0, 0, 0, 1, 2, 4, 4, 4, 4, 8, 6, 7, 7, 7, 7, 2, 1, 0, 0, 0],
[0, 0, 1, 2, 8, 4, 4, 4, 4, 8, 6, 7, 7, 7, 7, 6, 2, 1, 0, 0],
[0, 0, 1, 2, 8, 8, 4, 4, 8, 9, 9, 6, 7, 7, 6, 6, 2, 1, 0, 0],
[0, 0, 1, 2, 8, 8, 8, 8, 9, 9, 9, 9, 6, 6, 6, 6, 2, 1, 0, 0],
[0, 0, 1, 2, 3, 3, 3, 3, 9, 9, 9, 9, 3, 3, 3, 3, 2, 1, 0, 0],
[0, 0, 1, 2, 3, 3, 4, 4, 3, 9, 9, 3, 5, 5, 3, 3, 2, 1, 0, 0],
[0, 0, 1, 2, 3, 4, 4, 4, 4, 3, 3, 5, 5, 5, 5, 3, 2, 1, 0, 0],
[0, 0, 0, 1, 2, 4, 4, 4, 4, 3, 3, 5, 5, 5, 5, 2, 1, 0, 0, 0],
[0, 0, 0, 1, 2, 3, 4, 4, 3, 3, 3, 3, 5, 5, 3, 2, 1, 0, 0, 0],
[0, 0, 0, 0, 1, 2, 2, 3, 3, 3, 3, 3, 3, 2, 2, 1, 0, 0, 0, 0],
[0, 0, 0, 0, 0, 1, 1, 2, 2, 2, 2, 2, 2, 1, 1, 0, 0, 0, 0, 0],
[0, 0, 0, 0, 0, 0, 0, 1, 1, 1, 1, 1, 1, 0, 0, 0, 0, 0, 0, 0],
[0, 0, 0, 0, 0, 0, 0, 0, 0, 0, 0, 0, 0, 0, 0, 0, 0, 0, 0, 0],
[0, 0, 0, 0, 0, 0, 0, 0, 0, 0, 0, 0, 0, 0, 0, 0, 0, 0, 0, 0]
],
"rank": [
[6, 6, 6, 6, 6, 6, 6, 6, 6, 6, 6, 6, 6, 6, 6, 6, 6, 6, 6, 6],
[6, 6, 6, 6, 6, 6, 6, 6, 6, 6, 6, 6, 6, 6, 6, 6, 6, 6, 6, 6],
[6, 6, 6, 6, 6, 6, 6, 3, 3, 3, 3, 3, 3, 6, 6, 6, 6, 6, 6, 6],
[6, 6, 6, 6, 6, 3, 3, 5, 5, 5, 5, 5, 5, 3, 3, 6, 6, 6, 6, 6],
[6, 6, 6, 6, 3, 5, 5, 6, 6, 6, 4, 4, 4, 5, 5, 3, 6, 6, 6, 6],
[6, 6, 6, 3, 5, 6, 7, 7, 6, 6, 4, 4, 5, 5, 4, 5, 3, 6, 6, 6],
[6, 6, 6, 3, 5, 7, 7, 7, 7, 6, 4, 5, 5, 5, 5, 5, 3, 6, 6, 6],
[6, 6, 3, 3, 6, 7, 7, 7, 7, 6, 4, 5, 5, 5, 5, 4, 3, 3, 6, 6],
[6, 6, 3, 3, 6, 6, 7, 7, 6, 8, 8, 4, 5, 5, 4, 4, 3, 3, 6, 6],
[6, 6, 3, 3, 6, 6, 6, 6, 8, 8, 8, 8, 4, 4, 4, 4, 3, 3, 6, 6],
[6, 6, 3, 3, 1, 1, 1, 1, 8, 8, 8, 8, 1, 1, 1, 1, 3, 3, 6, 6],
[6, 6, 3, 3, 1, 1, 2, 2, 1, 8, 8, 1, 3, 3, 1, 1, 3, 3, 6, 6],
[6, 6, 3, 3, 1, 2, 2, 2, 2, 1, 1, 3, 3, 3, 3, 1, 3, 3, 6, 6],
[6, 6, 6, 3, 1, 2, 2, 2, 2, 1, 1, 3, 3, 3, 3, 1, 3, 6, 6, 6],
[6, 6, 6, 3, 1, 1, 2, 2, 1, 1, 1, 1, 3, 3, 1, 1, 3, 6, 6, 6],
[6, 6, 6, 6, 3, 1, 1, 1, 1, 1, 1, 1, 1, 1, 1, 3, 6, 6, 6, 6],
[6, 6, 6, 6, 6, 3, 3, 1, 1, 1, 1, 1, 1, 3, 3, 6, 6, 6, 6, 6],
[6, 6, 6, 6, 6, 6, 6, 3, 3, 3, 3, 3, 3, 6, 6, 6, 6, 6, 6, 6],
[6, 6, 6, 6, 6, 6, 6, 6, 6, 6, 6, 6, 6, 6, 6, 6, 6, 6, 6, 6],
[6, 6, 6, 6, 6, 6, 6, 6, 6, 6, 6, 6, 6, 6, 6, 6, 6, 6, 6, 6]
],
"clima": [
[ 0,-10,-20,-20,-20,-20,-20,-20,-20,-20,-20,-20,-20,-20,-20,-20,-20,-20,-10,  0],
[ 0,-10,-10,-10,-10,-10,-10,-10,-10,-10,-10,-10,-10,-10,-10,-10,-10,-10,-10,  0],
[ 0,-20,-20,-20,-20,-20,-20,-20,-20,-20,  0,  0,  0,  0,  0,  0,  0,  0,  0,  0],
[ 0,-20,-20,-20,-20,-20,-20,-20,-20,-20,  0,  0,  0,  0,  0,  0,  0,  0,  0,  0],
[ 0,-30,-30,-30,-30,-30,-30,-30,-30,-30,  0,  0,  0,  0,  0,  0,  0,  0,  0,  0],
[ 0,-20,-20,-20,-20,-20,-20,-20,-20,-20,  0,  0,  0,  0,  0,  0,  0,  0,  0,  0],
[ 0,-20,-20,-20,-20,-20,-20,-20,-20,-10, 10, 10, 10, 10, 10, 10, 10, 10, 10, 10],
[ 0,-10,-10,-10,-10,-10,-10,-10,-10,  0, 20, 10, 10, 10, 10, 10, 10, 10, 10, 10],
[ 0,-10,-10,-10,-10,-10,-10,-10,  0, 30, 40, 20, 20, 20, 20, 20, 20, 20, 20, 20],
[ 0,  0,  0,  0,  0,  0,  0,  0, 30, 50, 50, 40, 20, 20, 20, 20, 20, 20, 20, 20],
[10, 10, 10, 10, 10, 10, 10, 20, 40, 50, 50, 40, 20, 20, 20, 20, 20, 20, 20, 20],
[20, 20, 20, 20, 20, 20, 20, 20, 30, 40, 40, 30, 20, 20, 20, 20, 20, 20, 20, 20],
[20, 20, 20, 20, 20, 20, 20, 20, 20, 30, 30, 20, 20, 20, 20, 20, 20, 20, 20, 20],
[20, 20, 20, 20, 20, 20, 20, 20, 20, 20, 20, 20, 20, 20, 20, 20, 20, 20, 20, 20],
[20, 20, 20, 20, 20, 20, 20, 20, 20, 20, 20, 20, 20, 20, 20, 20, 20, 20, 20, 20],
[20, 20, 20, 20, 20, 20, 20, 20, 20, 20, 20, 20, 20, 20, 20, 20, 20, 20, 20, 20],
[20, 20, 20, 20, 20, 20, 20, 20, 20, 20, 20, 20, 20, 20, 20, 20, 20, 20, 20, 20],
[20, 20, 20, 20, 20, 20, 20, 20, 20, 20, 20, 20, 20, 20, 20, 20, 20, 20, 20, 20],
[10, 10, 10, 10, 10, 10, 10, 10, 10, 10, 10, 10, 10, 10, 10, 10, 10, 10, 10, 10],
[10, 10, 10, 10, 10, 10, 10, 10, 10, 10, 10, 10, 10, 10, 10, 10, 10, 10, 10, 10]
],
"nome": [
["", "", "", "", "", "", "", "", "", "", "", "", "", "", "", "", "", "", "", ""],
["", "", "", "", "", "", "", "", "", "", "", "", "", "", "", "", "", "", "", ""],
["", "", "", "", "", "", "", "", "", "", "", "", "", "", "", "", "", "", "", ""],
["", "", "", "", "", "", "", "", "", "", "", "", "", "", "", "", "", "", "", ""],
["", "", "", "", "", "", "", "", "", "", "", "", "", "", "", "", "", "", "", ""],
["", "", "", "", "", "", "", "", "", "", "", "", "", "", "", "", "", "", "", ""],
["", "", "", "", "", "", "", "", "", "", "", "", "", "", "", "", "", "", "", ""],
["", "", "", "", "", "", "", "", "", "", "", "", "", "", "", "", "", "", "", ""],
["", "", "", "", "", "", "", "", "", "", "", "", "", "", "", "", "", "", "", ""],
["", "", "", "", "", "", "", "", "", "", "", "", "", "", "", "", "", "", "", ""],
["", "", "", "", "", "", "", "", "", "", "", "", "", "", "", "", "", "", "", ""],
["", "", "", "", "", "", "", "", "", "", "", "", "", "", "", "", "", "", "", ""],
["", "", "", "", "", "", "", "", "", "", "", "", "", "", "", "", "", "", "", ""],
["", "", "", "", "", "", "", "", "", "", "", "", "", "", "", "", "", "", "", ""],
["", "", "", "", "", "", "", "", "", "", "", "", "", "", "", "", "", "", "", ""],
["", "", "", "", "", "", "", "", "", "", "", "", "", "", "", "", "", "", "", ""],
["", "", "", "", "", "", "", "", "", "", "", "", "", "", "", "", "", "", "", ""],
["", "", "", "", "", "", "", "", "", "", "", "", "", "", "", "", "", "", "", ""],
["", "", "", "", "", "", "", "", "", "", "", "", "", "", "", "", "", "", "", ""],
["", "", "", "", "", "", "", "", "", "", "", "", "", "", "", "", "", "", "", ""]
],
"ocupação": [
[0, 0, 0, 0, 0, 0, 0, 0, 0, 0, 0, 0, 0, 0, 0, 0, 0, 0, 0, 0],
[0, 0, 0, 0, 0, 0, 0, 0, 0, 0, 0, 0, 0, 0, 0, 0, 0, 0, 0, 0],
[0, 0, 0, 0, 0, 0, 0, 0, 0, 0, 0, 0, 0, 0, 0, 0, 0, 0, 0, 0],
[0, 0, 0, 0, 0, 0, 0, 0, 0, 0, 0, 0, 0, 0, 0, 0, 0, 0, 0, 0],
[0, 0, 0, 0, 0, 0, 0, 0, 0, 0, 0, 0, 0, 0, 0, 0, 0, 0, 0, 0],
[0, 0, 0, 0, 0, 0, 0, 0, 0, 0, 0, 0, 0, 0, 0, 0, 0, 0, 0, 0],
[0, 0, 0, 0, 0, 0, 0, 0, 0, 0, 0, 0, 0, 0, 0, 0, 0, 0, 0, 0],
[0, 0, 0, 0, 0, 0, 0, 0, 0, 0, 0, 0, 0, 0, 0, 0, 0, 0, 0, 0],
[0, 0, 0, 0, 0, 0, 0, 0, 0, 0, 0, 0, 0, 0, 0, 0, 0, 0, 0, 0],
[0, 0, 0, 0, 0, 0, 0, 0, 0, 0, 0, 0, 0, 0, 0, 0, 0, 0, 0, 0],
[0, 0, 0, 0, 0, 0, 0, 0, 0, 0, 0, 0, 0, 0, 0, 0, 0, 0, 0, 0],
[0, 0, 0, 0, 0, 0, 0, 0, 0, 0, 0, 0, 0, 0, 0, 0, 0, 0, 0, 0],
[0, 0, 0, 0, 0, 0, 0, 0, 0, 0, 0, 0, 0, 0, 0, 0, 0, 0, 0, 0],
[0, 0, 0, 0, 0, 0, 0, 0, 0, 0, 0, 0, 0, 0, 0, 0, 0, 0, 0, 0],
[0, 0, 0, 0, 0, 0, 0, 0, 0, 0, 0, 0, 0, 0, 0, 0, 0, 0, 0, 0],
[0, 0, 0, 0, 0, 0, 0, 0, 0, 0, 0, 0, 0, 0, 0, 0, 0, 0, 0, 0],
[0, 0, 0, 0, 0, 0, 0, 0, 0, 0, 0, 0, 0, 0, 0, 0, 0, 0, 0, 0],
[0, 0, 0, 0, 0, 0, 0, 0, 0, 0, 0, 0, 0, 0, 0, 0, 0, 0, 0, 0],
[0, 0, 0, 0, 0, 0, 0, 0, 0, 0, 0, 0, 0, 0, 0, 0, 0, 0, 0, 0],
[0, 0, 0, 0, 0, 0, 0, 0, 0, 0, 0, 0, 0, 0, 0, 0, 0, 0, 0, 0]
],
"contaminação": [
[0, 0, 0, 0, 0, 0, 0, 0, 0, 0, 0, 0, 0, 0, 0, 0, 0, 0, 0, 0],
[0, 0, 0, 0, 0, 0, 0, 0, 0, 0, 0, 0, 0, 0, 0, 0, 0, 0, 0, 0],
[0, 0, 0, 0, 0, 0, 0, 0, 0, 0, 0, 0, 0, 0, 0, 0, 0, 0, 0, 0],
[0, 0, 0, 0, 0, 0, 0, 0, 0, 0, 0, 0, 0, 0, 0, 0, 0, 0, 0, 0],
[0, 0, 0, 0, 0, 0, 0, 0, 0, 0, 0, 0, 0, 0, 0, 0, 0, 0, 0, 0],
[0, 0, 0, 0, 0, 0, 0, 0, 0, 0, 0, 0, 0, 0, 0, 0, 0, 0, 0, 0],
[0, 0, 0, 0, 0, 0, 0, 0, 0, 0, 0, 0, 0, 0, 0, 0, 0, 0, 0, 0],
[0, 0, 0, 0, 0, 0, 0, 0, 0, 0, 0, 0, 0, 0, 0, 0, 0, 0, 0, 0],
[0, 0, 0, 0, 0, 0, 0, 0, 0, 0, 0, 0, 0, 0, 0, 0, 0, 0, 0, 0],
[0, 0, 0, 0, 0, 0, 0, 0, 0, 0, 0, 0, 0, 0, 0, 0, 0, 0, 0, 0],
[0, 0, 0, 0, 0, 0, 0, 0, 0, 0, 0, 0, 0, 0, 0, 0, 0, 0, 0, 0],
[0, 0, 0, 0, 0, 0, 0, 0, 0, 0, 0, 0, 0, 0, 0, 0, 0, 0, 0, 0],
[0, 0, 0, 0, 0, 0, 0, 0, 0, 0, 0, 0, 0, 0, 0, 0, 0, 0, 0, 0],
[0, 0, 0, 0, 0, 0, 0, 0, 0, 0, 0, 0, 0, 0, 0, 0, 0, 0, 0, 0],
[0, 0, 0, 0, 0, 0, 0, 0, 0, 0, 0, 0, 0, 0, 0, 0, 0, 0, 0, 0],
[0, 0, 0, 0, 0, 0, 0, 0, 0, 0, 0, 0, 0, 0, 0, 0, 0, 0, 0, 0],
[0, 0, 0, 0, 0, 0, 0, 0, 0, 0, 0, 0, 0, 0, 0, 0, 0, 0, 0, 0],
[0, 0, 0, 0, 0, 0, 0, 0, 0, 0, 0, 0, 0, 0, 0, 0, 0, 0, 0, 0],
[0, 0, 0, 0, 0, 0, 0, 0, 0, 0, 0, 0, 0, 0, 0, 0, 0, 0, 0, 0],
[0, 0, 0, 0, 0, 0, 0, 0, 0, 0, 0, 0, 0, 0, 0, 0, 0, 0, 0, 0]
],
"recursos": [
[1, 1, 1, 1, 1, 1, 1, 1, 1, 1, 1, 1, 1, 1, 1, 1, 1, 1, 1, 1],
[1, 1, 1, 1, 1, 1, 1, 1, 1, 1, 1, 1, 1, 1, 1, 1, 1, 1, 1, 1],
[1, 1, 1, 1, 1, 1, 1, 1, 1, 1, 1, 1, 1, 1, 1, 1, 1, 1, 1, 1],
[1, 1, 1, 1, 1, 1, 1, 1, 1, 1, 1, 1, 1, 1, 1, 1, 1, 1, 1, 1],
[1, 1, 1, 1, 1, 1, 1, 1, 1, 1, 1, 1, 1, 1, 1, 1, 1, 1, 1, 1],
[1, 1, 1, 1, 1, 1, 1, 1, 1, 1, 1, 1, 1, 1, 1, 1, 1, 1, 1, 1],
[1, 1, 1, 1, 1, 1, 1, 1, 1, 1, 1, 1, 1, 1, 1, 1, 1, 1, 1, 1],
[1, 1, 1, 1, 1, 1, 1, 1, 1, 1, 1, 1, 1, 1, 1, 1, 1, 1, 1, 1],
[1, 1, 1, 1, 1, 1, 1, 1, 1, 1, 1, 1, 1, 1, 1, 1, 1, 1, 1, 1],
[1, 1, 1, 1, 1, 1, 1, 1, 1, 1, 1, 1, 1, 1, 1, 1, 1, 1, 1, 1],
[1, 1, 1, 1, 1, 1, 1, 1, 1, 1, 1, 1, 1, 1, 1, 1, 1, 1, 1, 1],
[1, 1, 1, 1, 1, 1, 1, 1, 1, 1, 1, 1, 1, 1, 1, 1, 1, 1, 1, 1],
[1, 1, 1, 1, 1, 1, 1, 1, 1, 1, 1, 1, 1, 1, 1, 1, 1, 1, 1, 1],
[1, 1, 1, 1, 1, 1, 1, 1, 1, 1, 1, 1, 1, 1, 1, 1, 1, 1, 1, 1],
[1, 1, 1, 1, 1, 1, 1, 1, 1, 1, 1, 1, 1, 1, 1, 1, 1, 1, 1, 1],
[1, 1, 1, 1, 1, 1, 1, 1, 1, 1, 1, 1, 1, 1, 1, 1, 1, 1, 1, 1],
[1, 1, 1, 1, 1, 1, 1, 1, 1, 1, 1, 1, 1, 1, 1, 1, 1, 1, 1, 1],
[1, 1, 1, 1, 1, 1, 1, 1, 1, 1, 1, 1, 1, 1, 1, 1, 1, 1, 1, 1],
[1, 1, 1, 1, 1, 1, 1, 1, 1, 1, 1, 1, 1, 1, 1, 1, 1, 1, 1, 1],
[1, 1, 1, 1, 1, 1, 1, 1, 1, 1, 1, 1, 1, 1, 1, 1, 1, 1, 1, 1]
]
}
